    ###
   ##.#
  ##  #
 ##   #
##    #
#@$$ ##
#.  ##
#####