  ####
###  #
# $@ ##
# . . #
##  $ #
 #  ###
 ####