  ####
###  #
# $@ ##
# .#  #
##    #
 #  ###
 ####