####
#+ ##
#.  ##
# $$ #
##   #
 ##  #
  ####