#####
#   ##
# $  ##
##    #
 ##   #
  ## +#
   ####