#####
#  ###
#  $ #
#  @.#
######