#########
#       #
# $ #.  #
##@### ##
#       #
# ####  #
#       #
#########