  #####
###   ###
#   #   #
# # $   #
#   + # #
#########