######
# .+ #
# $$ #
## ####
##    #
#   # #
# #   #
#   ###
#####