###    ####
#@######  ##
#.$        #
#########  #
##  #  ## ##
#       # #
#  ###  # #
## #    # ##
#  ######  #
#          #
##  ####  ##
 ####  ####